Unknown	Unknown	...	
Unknown	Unknown	... IM	
Unknown	Unknown	... in-na-ad-nu	
Unknown	Unknown	... na-s,ir	
Unknown	Unknown	... x	
Unknown	Unknown	... x (x)	
Unknown	Unknown	... x-a-x	
Unknown	Unknown	...-iszkur	
Unknown	Unknown	...-mu-tim	
Unknown	Unknown	...-na-s,ir	
Unknown	Unknown	...-sin	
Unknown	Unknown	...-te-er	
Unknown	Unknown	...-um	
Unknown	Unknown	...-utu	
Unknown	Unknown	...-x	
Ilum-x-x-x	Ilum-x-ar-bi	...-x-ar-bi		
x-x-bāniša	x-x-bāniša	...-x-ba-ni-sza	
Unknown	Unknown	...-x-ni	
Unknown	Unknown	...-x-x	
Unknown	Unknown	......	
Unknown	Unknown	($erasure$)	
Unknown	Unknown	a-...-x	
Aja-ilīšu	Aya-ili+szu	a-a-i3-li2-su	
(Abā)	Abā	a-ba-a	
(Abāšu)	Abāšu	a-ba-a-szu	
Abiḫa-x	Abiḫa-x	a-bi-ha-x (x)	Correct transliteration: ha -> ih ?
Abīkurrub	Abī-kurub	a-bi-ku-ru-ub	
(Abiduab)	Abiduab	a-bi2-du10-ab	
Abubum	Abukum	a-bu-ku-um	Reschid reads bu
(Abuma)	Abuma	a-bu-ma	
(Abuni)	Abuni	a-bu-ni	
Abumilum	Abumilum	a-bu-um-dingir	
Addaja	Addaya	a-da-ia	
(Adallal)	Adallal	a-da-lal3	
Gama-x-x	Agama-x-x	a-ga-ma-...	Reschid diverges fromCDLI
(Agū'a)	Agū'a	a-gu-a	
(Agū'a)	Agu+a	a-gu-u2-a	
Aḫātum	Aḫātum	a-ha-tum	
Aḫīmaraṣ	Aḫī-maraṣ	a-hi-ma-ra-as,	
(Ahi-x-l)a	Ahi-x-la	a-hi-x-la	
Aḫamarši	Aḫumarši	a-hu-mar-szi	Correct transliteration: ḫu --> ḫa
Aḫūni	Aḫūni	a-hu-ni	
Aḫum	Aḫum	a-hu-um	
Aḫu'ummīšu	Aḫu'ummīšu	a-hu-um-mi-szu	
Aḫūwaqar	Aḫu-waqar	a-hu-wa-qar	
Alinišūa	A'ilīšūa	a-i3-li2-szu-u2-a	If Reschid is right then transliteration should be corrected.
Ilumajišmu-x	Ilumajišmu-x	a-ii-isz-mu-x	Big divergent reading by Reschid
Ali-x-x	Ali-x-x	a-li-(x)-x	
Alija	Ālīya	a-li-a	It's the same as a-li-ia, father of Ibnimarru
Aliaḫuja	Ālī-aḫuya	a-li-a-hu-ia	
Aliaḫuja	Ālī-aḫuya	a-li2-a-hu-ia	
Alija	Ālīya	a-li-ia	
Ali'ātum	Ali-ātum	a-li-ia-tum	
Alim	Alim	a-li-im	
Alibānišu	Ali-bānišu	a-li2-ba-ni-szu	
Ali'ilum	Ali-ilum	a-li2-dingir	
(Ali'illati)	Ali'illati	a-li2-illat-ti	
Ali-PA.AN	Ali-PAN	a-li2-PA-AN	
Amatsîn	Amat-Sîn	a-ma-at-suen	
Amurnarbišu	Amur-narbišu	a-mur-na-ar-bi-szu	
Anāku'ilumma	Anāku-ilumma	a-na-ku-dingir-ma	"One m or ""mm""?"
Ana-x-x-x	Ana-x-x-x	a-na-x-...	
Apalilī	Apalilī	a-pa-al-i3-li2	
Apililišu	Apil-ilīšu	a-pil-i3-li2-szu	
Apilsîn	Apil-Sîn	a-pil-sin	
Ati'illatum	Ati-illatum	a-ti-illat(KASKAL.KUR)	
(Awīl'ištar)	Awīl-ištar	a-we-el-esz18-dar	
Awīlilim	Awīl-ilim	a-wi-il-dingir	
Awīlilim	Awīl-ilim	a-wi-il(AL)-dingir	
Awīlilim	Awīl-ilim	a-wi-il-i3-li2	It is the same as the previous ones, as the envelope reads DINGIR
Awīlija	Awīlija	a-wi-li-ia	
Awīlum	Awīlum	a-wi-lum	
A-x-x-x-x-x	A-x-...	a-x-...	
Azu-x-x-x	Asû-x-x-x	a-zu-...	
(Abīlānum)	Abīlānum	a2-bi2-la-num2	
(Abbi-x-x-x)	Abbi-x-x-x	ab-bi-x-...	
Abderaḫ	Abdi-araḫ	ab-de-ra-ah	
Abderaḫ	Abdi-araḫ	ab-di-e-ra-ah	
Admati'ilī	Admati-ilī	ad-ma-ti-i3-li2	
Adnānum	Adnānum	ad-na-nu-um	
Aḫ-x-x-x	Aḫ-x-x-x	ah-...	
Aḫmarši	Aḫmarši	ah-mar-szi	
Akbaḫum	Aqbaḫum	ak-ba-hu-um	Aq or Ak?
Akšakmāgir	Akšak-māgir	akszak{ki}-ma-gir	
(Allata'ajar)	Allata-ajar	al-la-ta-a-a-ar(IGI)	
Ammurabi	Ammurabi	am-mu-ra-pi2	Transliteration ? Pi2 --> bi?
Amtilaba	Amtilaba	am-ti-la-ba	
AN-kām	Ankām	AN-KA-a-am	
(Anumpišamaš)	Anumpišamaš	an-nu-um-pi4-utu	
Aplum	Aplum	ap-lum	
Aqbum	Aqbum	aq-bu-um	
Aršiḫum	Aršiḫum	ar-szi-hu-um	
Wardija	Wardiya	ARAD-di-ia	
Waradilišu	Warad-ilišu	ARAD-i3-li2-szu	
Waradilišu	Warad-ilišu	ARAD2-i3-li2-szu	
Waradinanna	Warad-Inanna	ARAD-inanna	
Waradamurrim	Warad-Amurrim	ARAD-mar-tu	
(Waradšarratsuanna)	Warad-šarratsuanna	ARAD-nin-su4-an-na	
(Waradšarratšubur)	Warad-šarratšubur	ARAD-nin-szubur	
Waradsîn	Warad-Sîn	ARAD-sin	
Waradsîn	Warad-Sîn	ARAD-suen	
Waradša-x-x	Waradša-x-x	ARAD sza x (x) x	
Waradsîn	Warad-Sîn	ARAD2-sin	
Waradsîn	Warad-Sîn	ARAD2-suen	
Wardija	Wardiya	ARAD{+di}-ia	
Irdani	Irdani	ARAD2-da-ni	
Waradamurrim	Warad-Amurrim	ARAD2-mar-tu	
Waradsîn	Warad-Sîn	ARAD2-si	
Waradšamaš	Warad-Šamaš	ARAD2-utu	
Warad-x-x	Warad-x-x	ARAD2-x-x	
(Ašnan)	Ašnan	asznan	
Ašnantajjar	Ašnan-tayār	asznan-ta-ia-ar	
(Babbe)	Babbe	ba-ab-ba-e	
(Balṭušaḫu)	Balṭušaḫu	ba-al-t,u2-sza-hu	
(Baba)	Baba	ba-ba	
Qišti'ea	Qišti-Ea	ba-e2-a	
Qišti'ištar	Qišti-Ištar	ba-esz18-dar	
Bānija	Bāniya	ba-ni-ia	
(Baraum)	Barium	ba-ra-um	
Qištisîn	Qišti-Sîn	ba-suen	To confirm whether we need nig-ba ou only ba
Bazizum	Bazizum	ba-zi-zu-um	
Baṣum	Baṣum	ba-zu-um	
(Bar-x)	Bar-x	bar-x	
Bedilum	Bedilum	be-di-dingir	
Bedilum	Bedilum	be-di-lu-um	
Bedilum	Bedilum	be-di-lum	
Betum	Betum	be-e-tum	
Bēlšunu	Bēlšunu	be-el-szu-nu	
Bēltum	Bēltum	be-el-tu-um	
Bēltum	Bēltum	be-el-tum	
Bēlanum	Bēlanum	be-la-nu-um	
Bēlija	Bēliya	be-li2-ia	
(Bēlirē'ûm)	Bēli-rē'ûm	be-li2-sipa	
Bēlīqarrad	Bēlī-qarrad	be-li3-qar-ra-ad	
Bēlum	Bēlum	be-lum	
Billija	Billiya	bi-il-li-ia	
(Bikum)	Bikum	bi-kum	
Unknown	Unknown	bi-szu-BI-x	
Unknown	Unknown	BI-SZU-LA-utu	
Bitūa	Bitūa	bi-tu-u2-ia	
Bēlkittim	Bi-x-kitim	bi-x-ki-tim	Cdli diverges from Reschid
Binqatānum	Bīn-qāt-Anum	bi2-in-qa2-ta-nu-um	
Binqatānum	Bīn-qāt-Anum	bi2-in-qa2-tu-um	
Binqatānum	Bīn-qāt-Anum	bi2-qa2-ta-nu-um	
(Billa)	Billa	bil-la	
Bu-x-x-x	Bu-x-x-x	bu-...	
(Bulum)	Bulum	bu-lu-um	
Bunagum	Bunagum	bu-na-gu-um	
Būnilum	Bunn-ilum	bu-ni-lu-um	thanks to the god. (CAD B, s.v. bunna, 317) (Stamm 1939: 188)
Būnilum	Bunn-ilum	bu-ni-lum	
Būrija	Būriya	bu-ri-ia	
Būrija	Būriya	bur-ia	
Būṣatum	Būṣatum	bu-za-tum	
Būr-x	Būr-bara2	bur-bara2	
Būr-x	Būr-bara2	bur-bara2-(x)	How Reschid reads this?
Būradad	Būr-Adad	bur-iszkur	
Būrsîn	Būr-Sîn	bur-sin	
Būrsîn	Būr-Sîn	bur-suen	
Da-x-x-x-x	Da-x-x-x-x	da-...	
Dabinum	Dabinum	da-bi-nu-um	
Dadija	Dadiya	da-di-ia	
Dadija	Dadiya	da-KI-ia	Divergence
Dannan	Dannan	da-na-an	
Damgalum	Damgalnun	dam-gal-nun	
Dananilī	Dananilī	dan-an-i3-li2	
Ilī'atka	Ilī-atka	dingir-a-at-ka	
(Ilumabkal)	Ilumabkal	dingir-ab-kal	
Ilumbāni	Ilum-bani	dingir-ba-ni	
Ilumdanan	Ilum-dannan	dingir-da-na-an	
(Ilumēreš)	Ilum-ēreš	dingir-e-ri-isz	
(Ilumbītum)	Ilum-bītum	dingir-e2	
Ilumkāšid	Ilum-kāšid	dingir-ka-szi-id	
Ilamliṭṭul	Ilam-liṭṭul	dingir-lam-li-t,ul	
Ilamluṭṭul	Ilam-luṭṭul	dingir-lam-lu-t,u2-ul	
Ilamqī	Ilamqī	dingir-lam-qi2-i	
Ilumadad	Ilum-Adad	dingir-lum-iszkur	
Ilīqāp	Ilī-qāp	dingir-qa-ap	
Ilumrē'ûm	Ilum-rē'ûm	dingir-sipa	
Ilšubāni	Ilšu-bani	dingir-szu-ba-ni	
Ilšu'ibbišu	Ilšu-ibbišu	dingir-szu-i-bi-szu	
Ilumadad	Ilum-Adad	dingir-um-iszkur	
(Dugazida)	Dugazida	du11-ga-zi-da	
Mārilišu	Mār-ilišu	dumu-i3-li2-szu	
(Māramurrim)	Mār-Amurrim	dumu-mar-tu	
Mārsîn	Mār-Sîn	dumu-sin	
Māršamaš	Mār-Šamaš	dumu-utu	
Ebibum	Ebibum	e-bi-bu-um	
Elā	Elā	e-la-a	
(Elā-ak-nu-id)	Elā-ak-nu-id	e-la-ak-nu-id(DA)	
Erībam	Erībam	e-ri-ba-am	
Etelpīsîn	Etel-pī-Sîn	e-te-el-pi4-sin	
Etelkūbi	Etel-kūbi	e-tel-ku-bi	
Eanada	Eanada	e2-a-na-da	
Bītumbābil	Bītum-bābil	e2-ba-bil	
E-x-x-x-x	E-x-x-x-x	e2-x-x-x	
(Enki)	Enki	en-ki	
Ennamištar	Ennam-Ištar	en-nam-inanna	To keep the name of the goddess in Sumerian?
Ennamsîn	Ennam-Sîn	en-nam-sin	
Ennamtišpak	Ennam-Tišpak	en-nam-tiszpak	
Enninsîn	Ennin-Sîn	en-ni-in-sin	
Erēšea	Erēš-Ea	engar-e2-a	engar = uru4, apin = eresh
Irraqurād	Irra-qurād	er11-ra-ku-ra-ad	
Irraqurād	Irra-qurād	er11-ra-qu2-ra-ad	
(Errabāni)	Erra-bani	er3-ra-ba-ni	
Erragāšir	Erra-gāšir	er3-ra-ga-sze-er	
Irraqurād	Irra-qurād	er3-ra-qu2-ra-ad	
(Erra-tug-dul)	Erra-tug-dul	er3-ra-tug2-dul3	
Erēškūbi	Erēš-kūbi	eresz{esz}-ku-bi	
(Ištarilī)	Ištar-ilī	esz18-dar-dingir	
Ištarummī	Ištar-ummī	esz18-dar-um-mi	
Gagûm	Gagûm	ga-gu-um	
(Gari-ilum)	Gari-ilum	ga-ri-dingir	
Nagarum	Nagarum	ga-ru-um-sza	
Gīdānum	Gīdānum	gi-da-nu-um	
Gurrija	Gurriya	gur-ri-ia	
Gurrija	Gurriya	gu-ri-ia		
Guzzulum	Guzulum	gu-zu-lu	Correct transliteration to su2 http://www.archibab.fr/4DCGI/listestextes13.htm?WebUniqueID=26682610
Guzzulum	Guzulum	gu-zu-lu-um	
Ḫababu	Ḫababu	ha-ba-bu	
Ḫaiabni'ilum	Ḫaiabni-ilum	ha-ia-ab-ni-dingir	
Ḫajatum	Ḫayatum	ha-ia-tum	
Ḫarirum	Ḫarirum	ha-ri-ri-im	
(Ḫišātum)	Ḫišatum	hi-sza-tum	
Ḫudilum	Ḫudilum	hu-di-lu-um	
(Ḫumurum)	Ḫumurum	hu-mu-rum	
Ḫunānum	Ḫunānum	hu-na-nu-um	
(Ḫunubum)	Ḫunubum	hu-nu-bu-um	
Ḫuṣābum	Ḫuṣābum	hu-sa-bu-um	
Ḫušāšum	Ḫušāšum	hu-sza-szum	
Unknown	Unknown	i-...	
Iamnum	Iamnum	ia-am-nu-um	
Ibbija	Ibbiya	i-bi-ia	
Ibbiadad	Ibbi-Adad	i-bi-iszkur	
Ibbininšubur	Ibbi-Ninšubur	i-bi-nin-szubur	
Ib(b)sîn	Ibbi-Sîn	i-bi-sin	
(Ibbišaḫan)	Ibbišaḫan	i-bi-sza-ha-an	
Idi'arnī	Idi-arnī	i-di-ar-ni	
Idija	Idiya	i-di-i-a	
(Idilum)	Idilum	i-di3-lum	
Iddinea	Iddin-Ea	i-din-e2-a	
Iddinenlil	Iddin-Enlil	i-din-en-lil2	
Iddinmīšar	Iddin-Mīšar	i-din-mi-szar	
Iddinsîn	Idin-Sîn	i-din-suen	
I-KI-nu-NI-pušu	I-KI-nu-NI-pušu	i-KI-nu-NI-pu-szu	
Iku-x-x	Iku-x-x	i-ku-...	
Iludanan	Ilu-dannan	i-lu-da-na-an	
Ilušunu	Ilu-šunu	i-lu-szu-nu	
Imātum	Imātum	i-ma-a-tum	
Immerilī	Immer-ilī	i-mi-ir-i3-li2	
Inaja	Inaya	i-na-ia	
Ipiqištar	Ipiq-Ištar	i-pi2-iq-esz18-dar	
Ipiqša	Ipiqša	i-pi2-iq-sza	
(Ipiš)	Ipiš	i-pi2-isz	
Iqādilī	Iqâd-ilī	i-qa-<ad>-i3-li2	
Iqādilī	Iqâd-ilī	i-qa-ad-dingir	
Iqādilī	Iqâd-ilī	i-qa-ad-i3-li2	
Iqādšamaš	Iqâd-Šamaš	i-qa-ad-utu	
Iṣiašar	Iṣiašar	i-s,i2-a-szar	
Iṣṣurrīja	Iṣṣurrīya	i-s,ur-ri-ia	
Iṣiašar	Iṣiašar	i-si2-a-szar	
Išarilī	Išar-ilī	i-szar-dingir	
(Išarpadan)	Išarpadan	i-szar-pa2-dan	
Iziatu	Iziatu	i-zi-a-tu	
Ilī'atka	Ilī-atka	i3-li2-a-at-ka	
Ilīabinī	Ilī-abinī	i3-li2-a-bi-ni	
Ilīapia	Ilī-apia	i3-li2-a-PI-a	
Ilīasūni	Ilīasūni	i3-li2-a-su2-ni	
(Ilīašrāni)	Ilīašrāni	i3-li2-asz2-ra-ni	
Ilībāni	Ilī-bani	i3-li2-ba-ni	
Ilībēlī	Ilī-bēlī	i3-li2-be-li2	
Ilīdinam	Ilī-dinam	i3-li2-di-na-am	
(Ilīemuqī)	Ilī-emuqī	i3-li2-e-mu-qi2	
Ili'eraḫ	Ili-eraḫ	i3-li2-e-ra-ah	
Ilī'erībam	Ilī-erībam	i3-li2-e-ri-ba-am	
Ilī'idinnam	Ilī-idinnam	i3-li2-i-din-na-am	
Ilī'idinnam	Ilī-idinnam	i3-li2-i-din-nam	
Ilī'iqīšam	Ilī-iqīšam	i3-li2-i-qi2-sza	
Ilī'iqīšam	Ilī-iqīšam	i3-li2-i-qi2-sza-am	
Ilī'illatī	Ilī-illatī	i3-li2-illat-ti	
Ilī'išpiq	Ilī-išpiq	i3-li2-isz-pi-iq	
Ilī'išpiq	Ilī-išpiq	i3-li2-isz-pi2-iq	
Ilī'išranni	Ilī-išranni	i3-li2-isz-ra-an-ni	
(Ilīmābi)	Ilī-mābi	i3-li2-ma-a-bi	
Ilīpalûm	Ilī-palûm	i3-li2-pa-a-lu-um	
Ilīpalûm	Ilī-palûm	i3-li2-pa-a-lum	
Ilīpalûm	Ilī-palûm	i3-li2-pa-a-lu-mu	
Ilīpīšu	Ilī-ipīšu	i3-li2-pi-szu-u2	
Ilīpuzur	Ilī-puzur	i3-li2-pu-zur	
Ilīrābi	Ilī-rabi	i3-li2-ra-bi	
Ilīṣillī	Ilī-ṣillī	i3-li2-s,i2-li	
Ilišarrum	Ili-šarrum	i3-li2-sza-ru-um	
Ilišuabī	Ilišu-abī	i3-li2-szu-a-bi	
Ilšubāni	Ilīšu-bani	i3-li2-szu-ba-ni	Reschid diverges	
Ilītadi	Ilī-taddi	i3-li2-ta-di	
Ilītappa'e	Ilī-tappa'e	i3-li2-tab-ba-e	
Ilītūra	Ilī-itūra	i3-li2-tu-ra	
Ili-x-x-x	Ili-x-x-x	i3-li2-x (x)	
Ili-x-x	Ili-x-x	i3-li2-x-...	
Ilīrābi	Ilī-rābi	i3-li3-ra-bi	
Iaḫzurilum	Iaḫzurilum	ia-ah-su-ur-dingir	
Iaḫzurilum	Iaḫzurilum	ia-ah-zu-ur-dingir	
Iaknutaru	Iaknutaru	ia-ak-nu-ta-ru	
Iamnunum	Iamnunum	ia-am-nu-nu-um	
Iaplaḫilum	Iaplaḫilum	ia-ap-la-ah-dingir	
Iabulum	Iabulum	ia-bu-lu-um	
Iakuni	Iakuni	ia-ku-ni	
Iakuni	Iakuni	ia-ku(LU)-ni		
Iauškurum	Iauškurum	ia-usz-ku-ru-um	
Ibbinisaba	Ibbinisaba	ib-bi-nisaba	
Ibnatum	Ibnatum	ib-na-a-tum	
Ibnatum	Ibnatum	ib-na-tum	
(Ibnija)	Ibniya	ib-ni-ia	
Ibni'inanna	Ibni-Inanna	ib-ni-inanna	
Ibniadad	Ibni-Adad	ib-ni-iszkur	
Ibniamurrum	Ibni-Amurrum	ib-ni-mar-tu	
Ibnisîn	Ibni-Sîn	ib-ni-sin	
Ibnija	Ibniya	ib(UR)-ni-ia	
Igmilsîn	Igmil-Sîn	ig-mi-il-sin	
Iḫbitsîn	Iḫbit-Sîn	ih-bi-it-sin	
Ilkasîn	Ilka-Sîn	il-ka-sin	
Ilšubāni	Ilšu-bani	il-szu-ba-ni	
Iltani	Iltani	il-ta-ni	
Ilmušallim	Ilmušallim	il(AL)-mu-sza-lim	
Ilkasîn	Ilka-Sîn	il3-ka-sin	
Ilšurābi	Ilšu-rābi	il3-su-ra-bi	su or shu?	
Ilšubāni	Ilšu-bani	il3-szu-ba-ni	
Ilšu'ibbišu	Ilšu-ibbišu	il3-szu-i-bi-szu	
Ilšu'illassu	Ilšu-illassu	il3-szu-i-la-szu	
Ilšunāṣir	Ilšu-nāṣir	il3-szu-na-s,ir	
Imguja	Imguya	im-gu-ia	
Imgurrum	Imgurrum	im-gur-rum	
Imgursîn	Imgur-Sîn	im-gur-sin	
Imgursîn	Imgur-Sîn	im-gur-suen	
Immerilī	Immer-ilī	im-me-er-i3-li2	
Immerilī	Immer-ilī	im-mi-ir-i3-li2	
Im-x-nu-um	Im-x-nu-um	im-x-nu-um	
Ištarumakalum	Ištar-umakalum	inanna-u3-ma-ka-lum	
Inimmani	Inimmani	inim-ma-ni	
KA.{d}nanna-a-x	KA.{d}nanna-a-x	inim-nanna-a-x (x)	
KA-nanna-igen	Ka-nanna-igen	inim-nanna-i3-ge-en	
KA-ninazu	Ka-ninazu	inim-nin-a-zu	
Ipqu'adad	Ipqu-Adad	ip-qu2-iszkur	
Ipqunāri	Ipqu-nāri	ip-qu2-na-ri	
Ipquša	Ipquša	ip-qu2-sza	
Iqbi'ilī	Iqbi-ilī	iq-bi-i3-li2	
Iṣṣurnumu	Iṣṣurnumu	is,-s,ur-nu-nu	
Iširaḫ	Iširaḫ	isz-i-ra-ah	
Išmêlum	Išmêlum	isz-me-lu-um	
Išmēsîn	Išmēsîn	isz-me-suen	
Išmē-x-x-x	Išmē-x-x	isz-me-x-x	
Adadidinnam	Adad-idinnam	iszkur-i-din-nam	
Sataranabum	Sataranabum	isztaran-a-bu-um	
Unknown	Unknown	ka-...	
Kaspuša	Kašpuša	ka-asz2-pu-sza	Reshid diverges	
Kanašum	Kanašum	ka-na-szum	
Unknown	Unknown	KA-x-x	
Kalkalillatsu	Kalkal-tillassu	kal-kal-illat-su2	
Qibunum	Qibunum	ki-bu-nu-um	
Kīma'aḫija	Kīma'aḫija	ki-ma-a-hi-ia	
K/Dinum	K/Dinum	ki-nu-um	
Kubatum	Kubatum	ku-ba-tum	
Kūbija	Kūbiya	ku-bi-ia	
Kūbinādā	Kūbinādā	ku-bi-na-da	
(Kubunum)	Kubunum	ku-bu-nu-um	
Kubbuttum	Kubbuttum	ku-bu-tum	
Kunam	Kunam	ku-na-am	
(Kuniṣum)	Kuniṣum	ku-ni-s,um	
Kusapānum	Kusapānum	ku-sa-pa-nu-um	
Kuzzulum	Kuzzulum	ku-su2-lu-um	
Kurkudum	Kurkudum	ku-ur2-ku-du-um	
Kuzzulum	Kuzzulum	ku-zu-lu-um	
Lamanum	Lamanum	la-ma-nu-um	
Lamassatum	Lamassatum	la-ma-sa3-tum	
(Lilumdan)	Lilumdan	li-lum-dan	
Lipitenlil	Lipit-Enlil	li-pi-it-en-lil2	
Lušālim	Lušālim	lu-sza-lim	
Ludingirra	Ludingirra	lu2-dingir-ra	
Lu'enlil	Lu-enlil	lu2-en-lil2	
(Luginata)	Luginata	lu2-gi-na-ta	
(Lu'inimmabimeš)	Lu-inimmabimeš	lu2-inim-ma-bi-mesz	
Awīlamurrim	Awīl-Amurrim	lu2-mar-tu	
(Lusilimmata)	Lusimilmmata	lu2-silim-ma-ta	
Mannumkīsîn	Mannumkī-Sîn	ma-nu-um-ki-sin	
Māšum	Māšum	ma-szum	
Mattatum	Mattatum	ma-ta-tum	
Mati'araḫtim	Mati-araḫtim	ma-ti-a-ra-ah-tim	
Amurrum	Amurrum	mar-tu	
Amurrumnāṣir	Amurrum-nāṣir	mar-tu-na-s,ir	
Merānum	Mērânûm	me-ra-nu-um	
Milki'adad	Milki-Adad	mi-il-ki-iszkur	
Milkum	Milkum	mi-il-ku-um	
Milkum	Milkum	mi-il(AL)-ku-um	
Milkum	Milkum	mil-qum	
Mu-x-x-x	Mu-x-x-x	mu-...	
Mudarris	Mudarris	mu-da-ri-is,	
Muḫaddûm	Muḫaddûm	mu-ha-du-um	
Munalkapum	Munalkapum	mu-na-ak-ka-x	
Munalkapum	Munalkapum	mu-na-AL-KA-bu-um	
Munānum	Munānum	mu-na-nu-um	
Munawwirtum	Munawwirtum	mu-na-wi-ir-tum	
Munawwirum	Munawwirum	mu-na-wi-ru-um	Reschid also writes Munammirum, but this seems not tho be OB
Munawwirum	Munawwirum	mu-na-wi-rum	See under Ennamsîn in Reschid's list of names
(Mupaḫirum)	Mupaḫirum	mu-pa-hi-rum	
Muqannītum	Muqannītum	mu-qa2-ni-tum	
Mutumilum	Mutumilum	mu-tu-um-dingir	
Mutumilum	Mutumilum	mu-tum-dingir	
Mu-x-x-ummē	Mu-x-x-ummē	mu-x (x)-me	
Mu-x-x-ummē	Mu-x-x-ummē	mu-x-(x)-um-mi-e	
Naḫli'ilum	Naḫli-ilum	na-ah-li2-dingir	
Narbi'um	Narbi'um	na-ar-bi-um	
Nabi'enlil	Nabi-Enlil	na-bi-en-lil2	
Nabi'ilišu	Nabi-ilišu	na-bi-i3-li2-szu	
Naber-x-x	Naber-x-x	na-bi-ir-ga-x	
Nabilišu	Nabi-ilišu	na-bi-li2-szu	
Nabi'um	Nabi'um	na-bi-um	
Nabi'umma	Nabi'umma	na-bi-um-ma	
Nabi-x-x-um	Nabi-x-x-um	na-bi-x-x-um	
Na-KI-ḪI-im	Na-KI-ḪI-im	na-KI-hi-im	
Nakirum	Nakirum	na-ki-ru-um	
Namanum	Namanum	na-ma-ni-im	
Namurrassu	Namurrassu	na-mu-ra-su2	
Nanām	Nanāam	na-na-a-am	
Naqiḫum	Naqiḫum	na-qi2-hu-um	
Narāmilišu	Narām-ilišu	na-ra-am-i3-li2-szu	
(Nanna)	Nanna	nanna	
Nannamanšum	Nanna-mansum	nanna-ma-an-szum2	
Nanna-x	Nanna-x	nanna-x	
Nērib-x-x-x	Nērib-x-x-x	ne-ri-ib-da-ni-na	
(Nergal)	Negal	nergal	
(Nidnatim)	Nidnatim	ni-id-na-tim	
Nūršamaš	Nūr-Šamaš	ni-ur2-utu	
Nidnuša	Nidnuša	ni5-id-nu-sza	
(Nigsîn)	Nig-Sîn	nig2-suen	
(Niniqīšam)	Nin-iqīšam	nin-i-qi2-sza-am	
(Ninšubur)	Ninšubur	nin-szubur	
Ninšubur-x-x-x	Ninšubur-x-x-x	nin-szubur-...	
Ninšuburbāni	Ninšubur-bani	nin-szubur-ba-ni	
(Nisaba)	Nisaba	nisaba	
Nupānum	Nupānum	nu-pa-nu-um	
Nūrija	Nūriya	nu-ri-ia	
Nurrubum	Nūr-rubum	nu-ru-bu-um	
Nūrum	Nūrum	nu-ru-um	
(Numa)	Numa	nu-u2-ma	
Nuḫšaka	Nuḫšaka	nu-uh-sza-ka	
Nūršamaš	Nūr-Šamaš	nu-ur-utu	
Nūrilī	Nūrilī	nu-ur2-dingir	
(Nūrgibil)	Nūr-Gibil	nu-ur2-gibil6	
Nūrilišu	Nūrilišu	nu-ur2-i3-li2-szu	
Nūrišḫara	Nūr-Išḫara	nu-ur2-isz-ha-ra	
Nūradad	Nūr-Adad	nu-ur2-iszkur	
Nūrkabta	Nūr-Kabta	nu-ur2-kab-ta	
Nūrkūbi	Nūr-kūbi	nu-ur2-ku-bi	
Nūrninšubur	Nūr-Ninšubur	nu-ur2-nin-szubur	
(Nūrsîn)	Nūr-Sîn	nu-ur2-suen	
Nūršamaš	Nūr-Šamaš	nu-ur2-utu	
Nūr-x	Nūr-x	nu-ur2-x	
Paknum	Paknum	pa-ak-nu-um	
Palûm	Palûm	pa-al-lum	[From palûm (CAD P 70) reign, supremacy]
Palaṭum	Palaṭum	pa-la-t,um	
Palûm	Palûm	pa-lu-u2-um	
Palûm	Palûm	pa-lu-um	
(PI-dišidāni)	PI-dišidāni	PI-di-szi-da-ni	
Pūtum	Pūtum	pu-tu-um	
Pūtum	Pūtum	pu-tum	
Pulsatum	Pulsātum	pu-ul-za3-tum	[Feminine plural corresponding to the name Pu-lu-su-um (CAD P 505, s.v. pullusu).]
Pulsatum	Pulsātum	pu-ul-sa3-tum	
Puzzurum	Puzurum	pu-zu-ru-um	
Puzursîn	Puzur-Sîn	pu-zur-suen	
Puzur-x-x-x	Puzur-x-x-x	puzur4-...	From puzrum (CAD P 556), hidden place, shelter [in theoph. names, DN is shelter]
Puzuretaja	Puzur-etaya	puzur4-e-ta-ia	
(Puzurḫaja)	Puzur-ḫaja	puzur4-ha-ia3	
Puzurkūbi	Puzur-kūbi	puzur4-ku-bi	
Puzurninḫursagga	Puzur-Ninḫursagga	puzur4-nin-hur-sag-ga2	
Puzurnumušda	Puzur-Numušda	puzur4-nu-musz-da	
Puzur-x-x-x	Puzur-x-x-x	puzur4-x-...	
Qabil	Qabil	qa2-bi-il	
Qami-AN	Qami-AN	qa2-mi-dingir	
Qibunum	Qibunum	qi2-bu-nu-um	
Rasia	Rasia	ra-si-a	
Rīšilum	Rīš-ilum	ri-isz-dingir	
Rīšadad	Rīš-Adad	ri-isz-iszkur	
Rīšniraḫ	Rīš-Niraḫ	ri-isz-nirah	
Rīšnumušda	Rīš-Numušda	ri-isz-nu-musz-da	
Rizzia	Rizzia	ri-iz-zi-a	
(Rišātum)	Rišātum	ri-sza-tum	
Rubâtum	Rubātum	ru-ba-tum	
Saramanum	Ṣaramanum	s,a-ra-ma-nu-um	
Ṣillisîn	Ṣilli-Sîn	s,i-li2-suen	
Ṣillaša	Ṣillaša	s,i2-la-sza	
Ṣillinninurta	Ṣillin-Ninurta	s,il2-<li2>-nin-urta	
Ṣilli'adad	Ṣilli-Adad	s,il2-li2-iszkur	
Ṣillisîn	Ṣilli-Sîn	s,il2-li2-sin	
Ṣilliwēr	Ṣilli-Wēr	s,il2-li2-we-er	
(Sada-x-x-x)	Sada-x-x-x	sa-da <<x-x>>	
Sagum	Sagum	sa-gu-um	
Sakirum	Sakirum	sa-ki-ru-um	
Salilum	Salilum	sa-li-lum	
Samaja	Samaya	sa-ma-ia	
Sāmum	Sāmum	sa-mu-um	
(SI-āta)	SI-āta	SI-A-a-ta	
(SIG-ištar)	SIG-ištar	SIG-esz18-dar	
Sînimmatim	Sîn-immatim	sin im-ma-tim	
Sînabūšu	Sîn-abūšu	sin-a-bu-szu	
Sînabum	Sîn-abum	sin-a-bu-um	
Sînadallal	Sîn-adalal	sin-a-da-la-al	
Sînasû	Sîn-asû	sin-a-su	
Sînasû	Sîn-asû	sin-a-su2	
Sînasû	Sîn-asû	sin-a-zu	
Sînbābil	Sîn-bābil	sin-ba-bil	
Sînbāni	Sîn-bani	sin-ba-ni	
Sînbēlilī	Sîn-bēlilī	sin-be-el-i3-li2	
Sînbēlaplim	Sîn-bēlaplim	sin-be-el-ibila	
Sîndadija	Sîn-dādiya	sin-da-di-ia	
Sînerībam	Sîn-erībam	sin-e-ri-ba-am	
Sîngāmil	Sîn-gāmil	sin-ga-mi-il	
Sîngāmil	Sîn-gāmil	sin-ga-mil	
Sînidinnam	Sîn-idinnam	sin-i-di-nam	
Sînidinnam	Sîn-idinnam	sin-i-din-nam	
(Sînilišu)	Sîn-ilišu	sin-i-li-szu	
Sîniqīšam	Sîn-iqīšam	sin-i-qi2-sza	
Sîniqīšam	Sîn-iqīšam	sin-i-qi2-sza-am	
Sînitūra	Sîn-itūra	sin-i-tu-ra	
Sînitūšu	Sîn-ilišu	sin-i-tu-szu	tu or li?	
Sîniatum	Sîn-iatum	sin-ia-tum	
Sînibnišu	Sîn-ibnišu	sin-ib-ni-i-szu	
Sînimmātim	Sîn-immātim	sin-im-ma-tim	
Sînippašra	Sîn-ippašra	sin-ip-pa-asz-ra	
Sînkāšid	Sîn-kāšid	sin-ka-szi-id	
Sînnāṣir	Sîn-nāṣir	sin-na-s,ir	
Sînpuṭram	Sîn-puṭram	sin-pu-ut-ra-am	
Sînpuṭram	Sîn-puṭram	sin-pu-ut,-ra-<am>	
Sînpuṭram	Sîn-puṭram	sin-pu-ut,-ra-am	
Sînrēmenni	Sîn-rēmenni	sin-re-me-ni	
Sînšēme	Sîn-šeme	sin-sze-me	
Sînšēme	Sîn-šeme	sin-sze-me-e	
Sînšēme	Sîn-šeme	sin-sze-me-e-i	
Sîntappawēdu	Sîn-tappawēdu	sin-tab-ba-we-du	
Sîntappa'e	Sîn-tappa'e	sin-tab-ba-x	
(Sînublam)	Sîn-ublam	sin-ub-lam	
Sîn-x-x-x	Sîn-x-x-x	sin-x-...	
(Rē'ûmsîn)	Rē'ûm-Sîn	sipa-si-in	
SU-izbum	SU-izbum	su-iz-bu-um	
Sukkallija	Sukkalliya	su-ka-li-ia	
Sukkallim	Sukkallim	su-ka-lim	
(Sukkallum)	Sukkallum	su-ka-lu	
Supapum	Supapum	su-pa-pu-um	
Surarum	Surarum	su2-ra-ru-um	
Sîn	Sîn	suen	
Sîn-x-x-x	Sîn-x-x-x	suen-...	
Sînabum	Sîn-abum	suen-a-bu-um	
Sînbāni	Sîn-bani	suen-ba-ni	
(Sîndagarre)	Sîn-dagarre	suen-dam-gar3-re	
Sînerībam	Sîn-erībam	suen-e-ri-ba-am	
Sînerēš	Sîn-erēš	suenge-ri-isz	
Sînennam	Sîn-ennam	suen-en-nam	
Sîngāmil	Sîn-gāmil	suen-ga-mil	
Sîngāmil	Sîn-gāmil	suen-ga-mil x-x	
Sînḫegal	Sîn-ḫegal	suen-he2-gal2	
Sînidinnam	Sîn-idinnam	suen-i-din-nam	
Sîniqīšam	Sîn-iqīšam	suen-i-qi2-sza-am	
Sîni-x	Sîni-x	suen-i-x	
Sîniatum	Sîn-iatum	suen-ia-tum	
Sînibnišu	Sîn-ibnišu	suen-ib-ni-szu	
(Sîntillat)	Sîn-tillat	suen-il-la-at	
Sînimmātim	Sîn-immātim	suen-im-ma-tim	
Sînkāšid	Sîn-kāšid	suen-ka-szi-id	
Sînmāgir	Sîn-māgir	suen-ma-gi4-ir	
Sînmāgir	Sîn-māgir	suen-ma-gir	
Sînmāgir	Sîn-māgir	suen-ma-gir (x)	
Sînmāgir	Sîn-māgir	suen-ma-gir(HA)	
(Sînmušālim)	Sîn-mušālim	suen-mu-sza-lim	
(Sînnūrilī)	Sîn-nūrilī	suen-nu-ur2-i3-li2	
Sînmu-x-x-ar	Sîn-nu-x-x-ar	suen-nu-x-x-ar	
(Sînrē'ûm)	Sîn-rē'ûm	suen-sipa	
Sînšēme	Sîn-šeme	suen-sze-me-e	
Sînšēme	Sîn-šeme	suen-sze-mi	
(Sînšeni)	Sîn-šeni	suen-sze-ni	
Sîniqīšam	Sîn-iqīšam	suen(EN)-i3-qi2-sza-am	
Šalti	Šalti	sza-al-ti	
Ša'ilim	Ša-ilim	sza-dingir	
Ša'ilišu	Ša-ilišu	sza-i3-li2-szu	
Ša'išḫara	Ša-išḫara	sza-isz-ha-ra	
(Šalimilum)	Šalim-ilum	sza-lim-dingir	
Šamaja	Šamaya	sza-ma-ia	
Šamaiatum	Šamayatum	sza-ma-ia-tum	
Ša'amurrim	Ša-Amurrim	sza-mar-tu	
Ilniška	Ilniška	sza-ni-isz-ka	Reschid diverges fromCDLI
Šarratel	Šarratel	sza-ra-te-el	
Šarratel	Šarratel	sza-ra-ti-el	
Šarratum	Šarrātum	sza-ra-tum	
Šarrumadad	Šarrum-Adad	sza-ru-um-iszkur	
Šatija	Šatija	sza-ti-ia	
x-x-gal	x-x-gal	szagina-gal	
Šarrija	Šarrija	szar-ri-ia	
Šarrumadad	Šarrum-Adad	szar-ru-um-iszkur	
Šēlebum	Šēlebum	sze-li-bu-um	
Šērumdan	Šērumdan	sze-ru-da-an	
Šērumbāni	Šērum-bani	sze-ru-um-ba-ni	
Šērumdan	Šērumdan	sze-ru-um-da-an	
Šērumdan	Šērumdan	sze-ru-um-da-an(RUM)	
(Šipram)	Šipram	szi-ip-ra-am	
Šimatnūnum	Šimatnūnum	szi-ma-at-nu-nu-um	
Šinibutum	Šinibutum	szi-ni-bu-tum	
(Šu'enlil)	Su'enlil	szu-en-lil2	
Šuila	Šuila	szu-i-la	
Šū'išḫara	Šū-išḫara	szu-isz-ha-ra	
Šukkalim	Šukkalim	szu-ka-li-im	
Šumi'ilija	Šumi-ilija	szu-mi-i3-li2-ia	
Šumi'ilišu	Sumi-ilišu	szu-mi-i3-li2-szu	
Šumi'išḫara	Šumi-išḫara	szu-mi-isz-ha-ra	
Šumuliṣi	Šumuliṣi	szu-mu-li-s,i2	
Šummulibši	Šummulibši	szu-mu-um-li-ib-szi	
(Šuninḫursag)	Šu-Ninhursag	szu-nin-hur-sag-ga2	
(Šupeultum)	Šupeultum	szu-pe2-u2-ul-tum	
Ṭārrada	Ṭārrada	t,a-ar-ra-da	
Ṭābṣillašu	Ṭābṣillašu	t,a3-ab-s,i2-la-szu	
Ṭaqīšnani	Ṭaqīšnani	ta-qi2-isz-na-ni	
(Tapnī'ištar)	Tapnī-ištar	tab-ni-esz18-dar	
(Tabbaum)	Tabbaum	tab(BAR)-ba-u2-um	
Tišpaknāṣir	Tišapaknāṣir	tiszpak-na-s,ir	
(Tūramilī)	Tūramilī	tu-ra-am-i3-li2	
Ubārrum	Ubārrum	u-bar-rum	
Ubāršamaš	Ubār-Šamaš	u-bar-utu	
Utuja	Utuya	u-tu-ia	
Unknown	Unknown	u2-...	
Udi-x-x	Udi-x-x	u2-di-x-x	
Uqāja	Uqāya	u2-ka-ia	
Unabatum	Unabatum	u2-na-ba-tum	
Unabum	Unabum	u2-na-bu-um	
Uqašamaš	Uqašamaš	u2-qa-utu	
Uṣināwir	Uṣināwir	u2-s,i2-na-wi-ir	
Uṣurpi-x	Uṣurpi-x	u2-s,ur-pi4{+pi2}-x	
Uṣurwēda	Uṣurwēda	u2-s,ur-we-da	
Uṭulmani	Uṭulmami	u2-t,ul-ma-mi	
Utuja	Utuya	u2-tu-e	
Utuja	Utuya	u2-tu-ia	
(Utulmama)	Utulmama	u2-tul2-ma-ma	
Ummi'išḫara	Ummi-Išḫara	um-mi-isz-ha-ra	
(Urabsu)	Urabsu	ur-ab-zu	
(Urabzu)	Urabsu	ur-abzu	
(Urduku)	Urduku	ur-du-ku3	
(Urduku)	Urduku	ur-du-ku6	
(Urli)	Urli	ur-li	
(Urmama)	Urmama	ur-ma-ma	
(Uršulpa'e)	Uršulpa'e	ur-szul-pa-e3	
Ussatel	Ussatel	us2-sa-te-el	
Uštašni'ilum	Uštašni-El	usz-ta-asz-ni-dingir	
(Šamaš)	Šamaš	utu	
(Šamašbāni)	Šamaš-bani	utu-ba-ni	
Šamašbēlilī	Šamaš-bēlilī	utu-be-el-i3-li2	
Šamašilī	Šamaš-ilī	utu-dingir	
(Šamašdumqī)	Šamaš-dumqī	utu-du-um-qi2	
Šamašgāmil	Šamaš-gāmil	utu-ga-mil	
Šamašlamassu	Šamaš-lamassu	utu-la-ma-su2	
Šamašnāṣir	Šamaš-nāṣir	utu-na-s,i2-ir	
Šamašnāṣir	Šamaš-nāṣir	utu-na-s,ir	
Šamašnūrī	Šamaš-nūrī	utu-nu-ri	
Šamašrē'ûm	Šamaš-rē'ûm	utu-sipa	
Šamaš-x-x	Šamaš-x-x	utu-x-x	
Unknown	Unknown	x ...	
Unknown	Unknown	x (x)-x-ki-ni-isz-x-ba	
Waradamurrim	Warad-Amurrim	x ARAD-mar-tu	
Unknown	Unknown	x di-ni-di-suen	
Unknown	Unknown	x gu x-x	
Unknown	Unknown	x-x	
Unknown	Unknown	x-x ...	
Unknown	Unknown	x-x nu x	
Unknown	Unknown	x-x-x ...	
Unknown	Unknown	x-x-x lum-ma x	
Unknown	Unknown	x-x-x-x-x	
Unknown	Unknown	x-x-x-x-sza-x	
Unknown	Unknown	x-x-x-an-ni	
x-x-x-Šamaš	x-x-x-Šamaš	x-x-x-utu	
Unknown	Unknown	x-x-li-tum	
Unknown	Unknown	x-x-ra-ma	
Unknown	Unknown	x-x-szum	
Unknown	Unknown	x-x-x-du-um	
Unknown	Unknown	x-...	
Unknkwn	Unknown	x-(x)-x	
Unknown	Unknown	x-ga-ru-um	
x-nišat-x-x	x-nišat-x-x	x-ni-sza-at-x-x	
x-x-x-illayim	x-x-x-illatim	x-NI-x-i-la-tim	
x-rašubutum	x-rašubutum	x-ra-szu-ub-tum	
Šu'ila	Šu'ila	x-su2-i-la-am	
Unknown	Unknown	x-sza-am	
Unknown	Unknown	x-x-x (x)	
Unknown	Unknown	x-x-...	
Unknown	Unknown	x-x-a-bu-szu	
Unknown	Unknown	x-x-da	
Unknown	Unknown	x-x-nin-szubur	
Unknown	Unknown	x-x-ra-bi	
Unknown	Unknown	x-x-x	
Unknown	Unknown	x-x-x-...	
Unknown	Unknown	x-x-x-da	
Unknown	Unknown	x-x-x-um	
Unknown	Unknown	x-x-x-x	
Unknown	Unknown	x-x-x-x-x-nu	
Zarramum	Zarramum	za-ar-ra-mu-um	
Zabum	Zabum	za-bu-um	
(Zaḫum)	Zaḫum	za-hum	
Zanatim	Zanātim	za-na-tim	
Unknown	Unknown	za-ni-x-gal-rum	
Zazum	Zazum	za-zu-um	
Zi'atum	Zi-atum	zi-ia-tim	
(Zulalum)	Zulalum	zu-la-lum	
